....................
.........###........
....................
....................
....###.......###...
.....#........#.....
.....#........#.....
####################