....................
.........###........
....................
....................
....###.......###...
..............#.....
..............#.....
####################